3333333300002000000000000000000000000000
3333333000000000IHHHHHHHHHHHHHHHHHHHHHH0
3333330000000000M00000000000000000000000
3333330000002000M00000000020000000000000
3333330000000000M00000000000000000000000
3333330000000000M00000000000000000000000
3333000000000200M00000000000000000200000
3000000000000000M00200000000000000000000
0000000000000000M00000000000000000000000
0000200000002000M00000000000000000000000
0000000000000000M00000000000200000000000
0000000000000000M00000000000000000000000
0000000020000200M00002000000000000000000
0000000000000000000000000000000002000000
0000000000000000000000000200000000000000
0000000000000000000000000000000000200000
00AFFFFFFFFFD000002000000000000000000000
00@EEEEEEEEEC0000000000000000007========
00@EEEEEEEEEC00000000020000007=999999999
00@EEEEEEEEEC000000000000000089999999999
00?>>>>>>>>>B000000000000000089999999999
0000000000000000002000000000089999999999
0000000000000000000002000000089999999999